        #######
        #     #############
 ######## ### #           ###
 #        #f### #########   #
 #s#### # #     #       ### #
 ###    # ####### ### ###   #
   # ####         # ###   ###
   #    ###########     ###
   ####             #####
      ###############
