        #######
        #    f#############
 ######## ### #           ###
 #        # ### #########   #
 #s#### # #     #       ### #
 ###    # ####### ### ###   #
   # ####         # ###   ###
   #    ###########     ###
   ####             #####
      ###############
