        #######
        #     #############
 ######## ### #           ###
 #        # ### #########   #
 #s#### # #     #       ### #
 ###    # ####### ###f###   #
   # ####         # ###   ###
   #    ###########     ###
   ####             #####
      ###############
